###############################
#                             #
#    .........                #
#          ########   ...     #
#                             #
#                    ....     #
###############################